|-----------------------------------------------------------------------------|
|                                                                             |
| |--------------------------|        |-----------------------|               |
| |....\..@..5.......M.......|        |..............9D.......|               |
| |.........3................+########+.......E...............|-------|       |
| |........L.................|   #    |..................O........9D..|--|    |
| |....O............1........|   #    |..................................|--| |
| |----------+---------------|   #    |----+----------------|...............| |
|            #                 #############                |........W......| |
|            #                 #     |-----+------|         |1..............| |
|            #                 #     |............|         |...............| |
|            ###################     |....W....3..|   ######+...............| |
|            #                 #     |............|   #     |...............| |
|            #                 #     |-----+------|   #     |--------+------| |
|  |---------+-----------|     #           #          #              #        |
|  |.....\..2........1...|     #           #          #         |----+------| |
|  |.....................|     ########################         |...........| |
|  |.........1.......2...|     #           #                    |0..........| |
|  |...L.................|     #    |------+--------------------|...........| |
|  |.....................|     #    |.................4.....................| |
|  |.....................+##########+..........H.................H..........| |
|  |..7.......6..........|          |................7...................7..| |
|  |---------------------|          |---------------------------------------| |
|                                                                             |
|-----------------------------------------------------------------------------|
|-----------------------------------------------------------------------------|
|                                                                             |
| |--------------------------|        |-----------------------|               |
| |....\..@..5.......M.......|        |..............9D.......|               |
| |.........3................+########+.......E...............|-------|       |
| |........L.................|   #    |..................O........9D..|--|    |
| |....O............1........|   #    |..................................|--| |
| |----------+---------------|   #    |----+----------------|...............| |
|            #                 #############                |........W......| |
|            #                 #     |-----+------|         |1..............| |
|            #                 #     |............|         |...............| |
|            ###################     |....W....3..|   ######+...............| |
|            #                 #     |............|   #     |...............| |
|            #                 #     |-----+------|   #     |--------+------| |
|  |---------+-----------|     #           #          #              #        |
|  |.....\..2........1...|     #           #          #         |----+------| |
|  |.....................|     ########################         |...........| |
|  |.........1.......2...|     #           #                    |0..........| |
|  |...L.................|     #    |------+--------------------|...........| |
|  |.....................|     #    |.................4.....................| |
|  |.....................+##########+..........H.................H..........| |
|  |..7.......6..........|          |................7...................7..| |
|  |---------------------|          |---------------------------------------| |
|                                                                             |
|-----------------------------------------------------------------------------|
|-----------------------------------------------------------------------------|
|                                                                             |
| |--------------------------|        |-----------------------|               |
| |....\..@..5.......M.......|        |..............9D.......|               |
| |.........3................+########+.......E...............|-------|       |
| |........L.................|   #    |..................O........9D..|--|    |
| |....O............1........|   #    |..................................|--| |
| |----------+---------------|   #    |----+----------------|...............| |
|            #                 #############                |........W......| |
|            #                 #     |-----+------|         |1..............| |
|            #                 #     |............|         |...............| |
|            ###################     |....W....3..|   ######+...............| |
|            #                 #     |............|   #     |...............| |
|            #                 #     |-----+------|   #     |--------+------| |
|  |---------+-----------|     #           #          #              #        |
|  |.....\..2........1...|     #           #          #         |----+------| |
|  |.....................|     ########################         |...........| |
|  |.........1.......2...|     #           #                    |0..........| |
|  |...L.................|     #    |------+--------------------|...........| |
|  |.....................|     #    |.................4.....................| |
|  |.....................+##########+..........H.................H..........| |
|  |..7.......6..........|          |................7...................7..| |
|  |---------------------|          |---------------------------------------| |
|                                                                             |
|-----------------------------------------------------------------------------|
|-----------------------------------------------------------------------------|
|                                                                             |
| |--------------------------|        |-----------------------|               |
| |...\...@..5.......M.......|        |..............9D.......|               |
| |.........3................+########+.......E...............|-------|       |
| |........L.................|   #    |..................O........9D..|--|    |
| |....O............1........|   #    |..................................|--| |
| |----------+---------------|   #    |----+----------------|...............| |
|            #                 #############                |........W......| |
|            #                 #     |-----+------|         |1..............| |
|            #                 #     |............|         |...............| |
|            ###################     |....W....3..|   ######+...............| |
|            #                 #     |............|   #     |...............| |
|            #                 #     |-----+------|   #     |--------+------| |
|  |---------+-----------|     #           #          #              #        |
|  |.....\..2........1...|     #           #          #         |----+------| |
|  |.....................|     ########################         |...........| |
|  |.........1.......2...|     #           #                    |0..........| |
|  |...L.................|     #    |------+--------------------|...........| |
|  |.....................|     #    |.................4.....................| |
|  |.....................+##########+..........H.................H..........| |
|  |..7.......6..........|          |................7...................7..| |
|  |---------------------|          |---------------------------------------| |
|                                                                             |
|-----------------------------------------------------------------------------|
|-----------------------------------------------------------------------------|
|                                                                             |
| |--------------------------|        |-----------------------|               |
| |....\..@..5.......M.......|        |..............9D.......|               |
| |.........3................+########+.......E...............|-------|       |
| |........L.................|   #    |..................O........9D..|--|    |
| |....O............1........|   #    |..................................|--| |
| |----------+---------------|   #    |----+----------------|...............| |
|            #                 #############                |........W......| |
|            #                 #     |-----+------|         |1..............| |
|            #                 #     |............|         |...............| |
|            ###################     |....W....3..|   ######+...............| |
|            #                 #     |............|   #     |...............| |
|            #                 #     |-----+------|   #     |--------+------| |
|  |---------+-----------|     #           #          #              #        |
|  |.....\..2........1...|     #           #          #         |----+------| |
|  |.....................|     ########################         |...........| |
|  |.........1.......2...|     #           #                    |0..........| |
|  |...L.................|     #    |------+--------------------|...........| |
|  |.....................|     #    |.................4.....................| |
|  |.....................+##########+..........H.................H..........| |
|  |..7.......6..........|          |................7...................7..| |
|  |---------------------|          |---------------------------------------| |
|                                                                             |
|-----------------------------------------------------------------------------|
